1111111111111111111111111111111111
1E0000000000000000000C100000000001
1010010100101001101001000M00010101
1111111111111111001001000M00010101
1P0000000C00C0000000000000000000C1
1111111111111111111111111111111111