111111111111111111111111111
100000000000C000000000000E1
1P0000000000C0000000000M001
111111111111111111111111111